1111111111111111111111111
1ECCCCCCCCCCCCCCCCCCCCCC1
10CCCCCCCCCCCCCCCCCCCCCC1
10CCCCCCCCCCCCCCCCCCCCCC1
10CCCCCCCCCCCCCCCCCCCCCC1
10CCCCCCCCCCCCCCCCCCCCCC1
10CCCCCCCCCCCCCCCCCCCCCC1
1PCCCCCCCCCCCCCCCCCCCCCC1
1111111111111111111111111
